111111111111
101010C001E1
11P110000101
101000000001
111111111111
