1111111
10PEC11
1000C11
1111111

