1111111111111111111111
100000000000000001E101
11P110000000C000011101
1111111111111111111111
