1111111111111
1abcdefgh1111
100000000P011
1111111111111
