1111111111111111
11P11000010E0001
1C00000000000E01
1111111111111111
