111111111111
11P110000101
100000000001
1C0000000001
111111111111
