1111111111111111111111
10P00011C100001E111C11
1000001101000000111001
1100000000000011111101
1000000000000000000001
1000001111101111111111
1111111000000001111111
1111111011111101111111
11111110001C0001111111
1111111111111111111111
