1111111111111111
10P0000000000001
1111111111111101
1C11100000000001
1001001111111111
1101011000001111
11000100111C1111
10C1000111110001
1001101111100101
1100001111001101
1001000000011001
1C11011111100011
1111011111101011
1C00011C000010E1
1111111111111111
