111111111111
100010C001E1
10P010000101
100000000001
111111111111
