11111111111111111111111111111111111111111111111111111111111111111111111111111111111111111111111111111111111111111111111111
1P100010001000100010001000100010001000100010001000100010001000100010001000100010001000100010001000100010001000100010001CE1
10101010101010101010101010101010101010101010101010101010101010101010101010101010101010101010101010101010101010101010101011
10101010101010101010101010101010101010101010101010101010101010101010101010101010101010101010101010101010101010101010101011
10101010101010101010101010101010101010101010101010101010101010101010101010101010101010101010101010101010101010101010101011
10001000100010001000100010001000100010001000100010001000100010001000100010001000100010001000100010001000100010001000100011
11111111111111111111111111111111111111111111111111111111111111111111111111111111111111111111111111111111111111111111111111
