111111111111111111
1P00000C0C00C000E1
111111111111111111
